2,3,3,3,3,3,4
7,8,8,8,8,8,9
10,10,10,11,10,10,10
0,1,0,1,0,1,0
5,6,5,6,5,6,5
0,1,0,1,0,1,0
5,6,5,6,5,6,5
0,1,0,1,0,1,0
5,6,5,6,5,6,5
15,15,15,16,15,15,15
2,3,3,3,3,3,4
7,8,8,8,8,8,9
